111111111111111111111111111111111111111111
1CCCCCCCCCCCCCC1CCCCCCCCCCCCCCCCCCCCCCCCC1
1C111C1C1CC111C1C111C111C111C1C1C1C11111C1
1CCCCC1C1CCCC1CCC1CCC1CCC101C1C1C1CGCCCCC1
11111C1111C111C1C111C111C101C1C1C1C0C11111
1E000CCC1CC1CCC1CCC1C1CCC101C1C1C1GGGCCCC1
11111C0C1CC111C1C111C111C111C111C111C11111
1CCCCCCCCCCCCCCCCCCCCCCCCCCCCCCCCCCCCCCCC1
1C1111C1111111C1C11111C1C1C1C111111C1111C1
1PCCCCCCCCCCCCC1CCCCCCC1CCC1CCCCCCCCCCCCC1
111111111111111111111111111111111111111111