111111111111111
1CCCCCCCCCCCCE1
1C00000000000C1
1C00000000000C1
1C00000000000C1
1C000GGGGG000C1
1C000G000G000C1
1C000G0P0G000C1
1C000G000G000C1
1C000GGGGG000C1
1C00000000000C1
1C00000000000C1
1C00000000000C1
1CCCCCCCCCCCCC1
111111111111111