111111111111111
1CCCCCCCCCCCCC1
1CCCCCCCCCCCCC1
1CCCCCCCCCCCCC1
1CCCCCCCCCCCCC1
1CCCCCCCCCCCCC1
1CCCCCGGGCCCCC1
1CCCCCGEGCCCCC1
1CCCCCGGGCCCCC1
1CCCCCCCCCCCCC1
1CCCCCCCCCCCCC1
1CCCCCCCCCCCCC1
1CCCCCCPCCCCCC1
1CCCCCCCCCCCCC1
111111111111111